Ok guys here’s a very basic list of some of the most common translated words in Elvish.  



En  (ENN) -  Tree

Mae (may)  - Star

Luna (LOON-ah) -  Light

Lance (LONCE)  -  Sword  (the 'lon' part of that pronounciation is like in english lawn, not land)

Fae  (fay)  -  Sun

Lan  (LOHN)   -   Winter   (pronoucned like english 'lawn')

Ethan (Eh-THON)  -  Mute or Speechless (Eh pronounced like the first 'e' in english Chester, thon like thong)

Ros  (rowss)  -  Mare or Horse (pronounced like english gross without the 'g')

Wae (WAY)  -  Night

Mulda  (mull-DAH)  -  Forsaken   (Mull like the 'hull' of a ship, only with an 'm')

Grem  (GREEM)  -  Master   (like Green or Greem)  :)

Wen  (WEEN)  -  Hawk

At  (AHT)  -  World  (pronounced like ought in 'fought')

Ran  (RON)  -  Wind

Cro  (CROW)  -  Sea, Ocean

Tyr  (TEAR)     -   Long

Sath  (SAATH)  -  King  (pronounced like 'wraith' only with an 'S')

Ar  (ARE)   -   Earth

Myr  (MEER)  -   Stone

Astor  (AZ-tore)  -  Pillar

Goriand  (GORE-ee-and)  -  Bringer, to bring

Toriand   (TORE-ee-and)  -  Summoner, to summon

Mal  (Mal)  -  Shadow    (pronounced like mal in mallard or english name Malcolm)

Lor  (LORE)  -  The

Medefalon (mah-DEF-ah-lon) -  Avenge

Fe  (FAY)  -  Pronounced the same as 'sun', means Me or I.

Rek  (RECK)  -  Must

Aleo (ah-LAY-oh)  -  Fall (can be easily modified Aleon (ah-LAY-on) - Fallen)

Velda  (VEL-dah)  -  Wicked  (VEL as in velvet)

Vea  (VAY-ah)  -  Woe

Cyl   (KAI-ahl)  -  Tear

Cledsar (CLED-sarr) -  Watch

Sylen  (SILE-enn)  -  A type of giant tree

Fyr  (FEAR)  -   Flare

Pelda (PELL-dah)  -  Heart

Gulda (GULL-dah)  -  Green

Relda (RELL-dah)  -  Red

Selda (SELL-dah)  - Blue

Malda (MALL-dah)  - Black

Lunda (LOON-dah)  - White

Cor  (CORE)         -  Knight, Warrior

Ramacor (RAH-mah-core) -  Ranger, Arrow Warrior

Alda (AL-dah)       -  Pale 

Lewa (LEE-wah)   -  Bane

Mondal (MOHN-doll)  -  Spirit

Endal (ENN-doll) -  Magic

Paece  (PAY-see)  -  Dragon

Elda (ELL-dah)   -  Sky

Mare (MAIR)      -  Bridge

Te  (TAY)  -  Of

Wy  (WEE)  -  Is, Are, Am

Wa  (WAH)  -  As

Tur (TOOR) -  Like

Wyst  (WEEST)  -  Was

Now  (NO)  -  Did

Ne  (NEE)   -   Not

Cel (SELL)  -   Ruin

Ere  (AIR)   -   Mist

Pera (PER-ah) -  In

Tera (TER-ah) -  Out

Ysa   (EE-sah)  -  Land

Eswen (EZ-wenn) -  Forest



Imojen (EE-mo-JIN) - Travel  (thus Traveller = Imojenin)

Tsa (Sah)  -  Less

Tso (Soh)  -  More

Tsy (Sy)  -   Some



Edra (ED-ra)  - Fire

Leria (LER-ee-ah)  -  Liquid

Rogoth (ROW-goth)  -  Demon



Veldaleria (LER-ee-ah) -  Poison, wicked liquid.

Lo  (LOW)   -  And

Fo  (FOW)  -  But  (pronounced like ‘Bow’ in bow-and-arrows, cept with F)

To   (TOW)  -  Or  (pronounced like ‘Fo’ only with a T)

Uswed (OOS-wed)  -  Say, Speak



Numbers



Myo  (MEE-oh)  -  One

Syo   (SEE-oh)  -  Two

Dyo   (DEE-oh)  -  Three

Lyo   (LEE-oh)  -  Four

Nyo   (NEE-oh)  - Five

Kyo  (KEE-oh)  -  Six

Wyo  (WEE-oh)  -  Seven

Hyo   (HEE-oh)  -  Eight

Jyo    (JEE-oh)  -   Nine

Ryo   (REE-oh)  -  Zero



Modifiers to Numbers



Sa   (SAH)  -  Added to number makes it 10 more

Ra   (RAH)  -  Added to number makes it 100 more

Ma  (MAH)  -  Added to number makes it 1000 more

Masa  (MAH-sah)  -  Added to number makes it 10000 more

Mara  (RAH-sah)  -  Added to number makes it 100000 more

Mama  (MAH-mah)  - Added to number makes it 1000000 more





Jae (JAY)  -  It

Mel  (MELL)  - Good

Mele (MELL-ay) -  Order

Bel  (BELL)  - Bad

Se  (ZAY)  -  You

Aid   (EYE-d)   -  Be

Asd  (AZ-Dah)  -  Get

Kyr (KAI-err)  - Will

Kyae  (KAI-ay)  -  With

Nemro (NEEM-row)  -  Time

Orae  (OH-ray)  -  Last

Arae   (AH-ray)  -  Next

Paero  (PAY-row)  -  Yours, Your

Faero  (FAY-row)  - Mine, My

Dam (DOM)  -  Our

Ghed (GED)  -  Know  (pronounced like Said only with ‘G’)

O  (Oh)  -  To

Orre (OR-ay) -  From

A  (Ah)  -  Do

E  (EE)  -  Take/Achieve

Eya (EE-yah) -  Give

Anna (ah-NA) - Can

Benerat (BEN-er-oht)  -  Subdue

Ghod (GOD) -  See



'N SUFFIX  ('enn') -   Under

'T SUFFIX  ('ett') -   Over

Kyrea  (keer-EE-ah) -  Wing



Yma  (EE-mah)  - For



Tigas  (TIE-gahs)  - easy

Bigas  (BY-gahs)  -  difficult





Fie  (FEE)  -  Yes

Hie  (HEE)  - No



Kaned (kah-NAYD) -  Attack

Ago  (Ah-go) - Let

Aela  (Ay-lah) - Shine



Kale (KAH-lay)  -  Symbol

Well (WELL) -  Care

It    (EYE-t)   -  Ful

Eler (E-lair)    -  Want

Aler (AH-lair)  -  Need



Am  (AHM) -  Indicates action



Hers  (HURZ)  -  Us   (turn to 'Hersa' for we)

Mers (MURZ)  - Them   (turn to 'Mersa' for they)



Ya (YAH) -   Un



Leao (LEE-ay-oh)  - He, Male, Man

Seao  (SEE-ay-oh)  - She, Female, Woman

Leaone (LEE-ay-oh-nay)  -  FatherSeaone (SEE-ay-oh-nay)  -  Mother





Saer  (SAY-err)  -  Where

Taer  (TAY-err)  -  What

Waer  (WAY-err)  -  Who



Baer  (BAY-err)  -  Why

Naer  (NAY-err)  -  When



Kalae  (KAH-lay)  -  Here, Near

Palae  (PAH-lay)    -  There, Far

Yapalae (YA-pah-lay) -  Behind ('unthere')

Dumen  (DOO-men) -  On/Above





Sep  (SEHP)  -  Go

Tep  (TEHP)  -  Come

Tso  (SO)  -  More

Tsal  (SALL) -  Much



Paed  (PAID)  -  That

Paes  (PAY-ees) -  This





Renual (RAY-new-all) -  Day

Nual   (NEW-all)     -  Night

Melda  (MELL-dah)    -  Within





Maloas (MALL-oh-as)  -  Suffered

Gos   (GOSS)  -  Have





Time modifiers:



Nemran  (NEEM-ran)  -  Now

Nemrel  (NEEM-rel)  -  Soon

Nemwyn  (NEEM-ween)  -  Then

Nemsan  (NEEM-son)  -  Later

Nemgo  (NEEM-goh)  -  Forever

Nemso  (NEEM-soh)  -  Never



Diamed  (DIE-ah-med) -  Moon



Tanam  (TANN-am)  -  Walk

Ganam  (GANN-am)  -  Move



Seram  (SERR-ahm) -  River

Seralda (SERR-all-dah)  -  Rain



Kemena (KEH-mah-nah) -  Disciple



Luria  (LUR-ee-ah)  -  Life



Hersi gos maloas tsal, fo taero malrai kyr nemrel aid (ended)



Lumia  (LOO-mee-ah)  -  Love

Malia  (MALL-ee-ah)  - Hate

Ramat  (RAH-mat)  - Arrows







Po  (PO) -  Over/Too



Lymia (LEE-mee-ah) -   Revere/Awe



Malwy (MALL-wee) -  Fight



Ghedwyr (GHED-weer) -  Learn

Dyla  (DIE-lah)  - Gold/Money

Esa  (ESS-ah)  -  Through



El (ELL)  -  Prefix/Suffix for 'Relation/tie'

Der (DERR) -  Soul

Loma (LOW-mah) -  hope

Res  (REZ)  -  hard

Duna (DOO-nah)  - armor

Ky  (KEE)  -  means

Lum (LOOM) -  Brotherly love (sort've)

Sycant (SEE-cant) -  Protect



I  (EE) -  a, singular




